#####################
#P          #     # #
# ######### # # # # #
#     #   # # # #   #
##### # ### ### #####
# #   #   #     #   #
# # ##### ####### # #
# #     # #   #   # #
####### # # # # ### #
# #       # # # #   #
# # ### # # # # # ###
#   #   # # #   #   #
##### ### # # ##### #
# #   #   # #       #
# # ####### # # ### #
#   #     # # #   # #
##### # # #   ##### #
#   # # #   #   #   #
# ### # ####### # ###
#     #             P
#####################